{
  "boardWidth": 12,
  "boardLength": 10,
  "flags": [
    { "x": 0, "y": 0 },
    { "x": 11, "y": 9 }
  ],
  "terrain": [
    { "x": 5, "y": 2 },
    { "x": 5, "y": 3 },
    { "x": 5, "y": 4 },
    { "x": 6, "y": 4 },
    { "x": 6, "y": 5 },
    { "x": 6, "y": 6 },
    { "x": 5, "y": 6 },
    { "x": 5, "y": 7 }
  ]
}
